{
    "name": "Test Level 1",
    "player_pos": "(0, 0, -1)",
    "tex_bank": [
        "BLANK",
        "textures/enviroment/blocks/grass_block/grass_block.png",
        "textures/enviroment/blocks/stone_stairs/stone_stairs_E.png",
        "textures/enviroment/blocks/stone_stairs/stone_stairs_E.png",
        "textures/enviroment/blocks/stone_stairs/stone_stairs_S.png",
        "textures/enviroment/blocks/stone_stairs/stone_stairs_W.png",
        "textures/templates/full_block_template.png"
    ],
    "data": [
        [
            "00000000000000",
            "01000000111110",
            "00000011111110",
            "00011111111110",
            "00011110011110",
            "00000100011110",
            "00000000011110",
            "00100000011110",
            "00100000011110",
            "00100000110000",
            "00000011100000",
            "00010010000000",
            "00111110000000",
            "00000111000000",
            "00000010006000"
        ], [
            "60000000000000",
            "01000000111000",
            "00000000000000",
            "00041120000000",
            "00000510000010",
            "00000000000000",
            "00000000000000",
            "00100000000000",
            "00100000000000",
            "00100000110000",
            "00000000100000",
            "00010030000000",
            "00111110000600",
            "00000111000000",
            "00000010000000"
        ], [
            "00000000000000",
            "00000000000000",
            "00000000000000",
            "00000000000000",
            "00000000000000",
            "00000000000000",
            "00000000000000",
            "00000000000000",
            "00000000000000",
            "00000000000000",
            "00000000000000",
            "00000000000000",
            "00000000000000",
            "00000000000000",
            "00000000000000"
        ]
    ]
}